###############################
# #   #   #   #               #
# # ### # # # ### ##### # ### #
#   #   #   #       # # # #   #
# # ### ### # ### ###   # # ###
# #     #   # #     # # # #   #
# ### ####### # ##### ####### #
# #           #       #   #   #
# # ##### ### ####### # ### ###
# #   # #   #       # #     # #
# ##### # # ##### # # ### ### #
# #   #   # # #   #   #   #   #
# ### ##### # ####### # ### ###
#       # # #   #           # #
### ### # # # # ######### ### #
#   #         #             # #
### ##### # # # # ######### # #
#   # #   # # # # #           #
# # # ####### # ##### ##### # #
# #   #     # #   # #   #   # #
##### ##### ####### ### # #####
#     #             #   #     #
##### ### # # ### # # # ##### #
# #     # # # #   # # # # # # #
# ##### # ### # ##### # # # # #
#   #   # # # #       #   #   #
# ##### # # ##### ### ##### ###
#   #         #   #   # #     #
# # # ### # ### ##### # # # # #
# #     # #         #   # # # #
###############################
